R 4342423423 3232
F 26,156,104
C 3,61,255
SO texture/8/depositphotos_64906463-stock-photo-beautiful-flowers-background.xpm
EA texture/8/depositphotos_64906463-stock-photo-beautiful-flowers-background.xpm
WE texture/8/depositphotos_64906463-stock-photo-beautiful-flowers-background.xpm
NO texture/8/depositphotos_64906463-stock-photo-beautiful-flowers-background.xpm
S texture/8/8-march-happy-women-s-day_23-2147749905.xpm

11111111111111111111111111111111
10002000000000000000000020000001
10000000000200000000200000000001
1E000000000000000000000000020001
10000020000000000200000000000001
10020000000000000000000200000001
11111111111111111111111111111111