R 1920 1080
NO ./texture/wolftex_xpm/WALL33.xpm
SO texture/wolftex_xpm/WALL54.xpm
WE texture/wolftex_xpm/WALL64.xpm
EA texture/wolftex_xpm/WALL68.xpm
S texture/wolftex_xpm/HEADH0.xpm

F 220,100,0
C 225,30,0

1111111111111111111111111
1000020000110000000000001
1001000001110000000000001
100100000000000000000000111
111111111011000001110000001
10000000001100000111011111111
11110111111111011100000010001
11110111111111011101010010001
11000000110101011100000010001
10002000000000001100000010001
10000000000000001101010010001
11000001110101011111011110N0111
11110111 1110101 101111010001
11111111 1111111 111111111111