R 1920 1080
NO texture/ahegao_xpm/3893522.xpm
SO texture/ahegao_xpm/581739463571661590445879.xpm
WE texture/ahegao_xpm/b7747c4222f9ed7ebb5997d80570aef1.xpm
EA texture/ahegao_xpm/unnamed.xpm
S texture/wolftex_xpm/SARGE1M.xpm
F 220,100,0
C 225,30,0

1111111111111111111111111
1100000200110000000000001
1011000201110000002000001
10010002000000000000000011
100000000011000001110111111110
11110111111111011100000010001
11110111111111011101010010001
11000000110101011100000010001
10002000000000001100000010001
10000000000000001101010010001
11000001110101011111011110N0111
11110111 1110101 101111010021
11111111 1111111 111111111111