R 4342423423 3232
F 255,137,3
C 3,61,255
SO texture/1567106726159459734.xpm
EA texture/ahegao_xpm/unnamed.xpm
WE texture/ahegao_xpm/b7747c4222f9ed7ebb5997d80570aef1.xpm
NO texture/skachat-krasivye-kartinki-na-telefon-besplatno-44-650x1155.xpm
S texture/wolftex_xpm/SARGE1M.xpm

111
101
11111111111111111
10000000000000001
102S0000200000201
10000010100000001
10002000200020001
10000000000000001
102020200020202011
111111111111111111
111111111111111111
100000000000000011
10002000200200011
10000000000000001
10200000200002001
10000000000000001
11111111111111111